1111111111111
1001000000011
11001C1100011
101101P1E1C01
1111111111111