1111111111111111111
10101000000000000E1
1000100000001111111
101000000C100000001
1011000110101111101
100P10010C100000101
101110011C1000001C1
1111111111111111111