1111111111111
1001000000011
1100011100011
101100P1EC101
1111111111111