111111111111111111111111111
101C10000000000000000000001
1P1000011110111111101110101
10101000001000000010111C001
101010011010111110100011101
10001001C010000010101011101
101C10011C100C101C1000000E1
111111111111111111111111111