1111111111111
1001000000011
110001C111101
101100P1E0001
1111111111111