1111111111111111111
10101000000000000E1
1000100000001111111
101010000C100000001
1010000110101111101
101P10010C100000101
101010011C1000001C1
1111111111111111111